WWWWWWWWWWWWWWWWWWWWWWWWWWWWWWWWWWWWWWWWWWWWWWWWWWWWWWWWWWWWWWWWWWWWWWWWWWWWWWWW
W                                                                              W
W                                                                              W
W                                                                              W
W                                                                              W
W                                                             OOPOOO           W
W                                                          OOOOOOOOOOO         W
W                                                        OOOOO     OOOOO       W
W                                                       OOOOO       OOOOO      W
W                                                      OOOOO         OOOOO     W
W                                                     OOOOO           OOOOO    W
W                                                     OOO               OBO    W
W                                                     OsO               OBO    W
W                                                     OOO               OBO    W
W                                                     OsO               OOO    W
W                                                     OOO               OOO    W
W                                                     OOOOOOOOOO  OOOOOOOOO    W
W                                                     OOOOOOOSOO  OOOOOOOOO    W
W                                                     OOOOOOOOOO  OOOObOOOO    W
W                                                     OOOSOOOOOO  OObOOObOO    W
W                                                     OOOOOOOOOO  OOOObOOOO    W
W                                                     OOOOOOOOOOOOOObOOObOO    W
W                                                     OOOOOOOOOO  OOOOOOOOO    W
W                                                     OOOOOSOOOO  OOObOObOO    W
W                                                     OOOOOOOOOO  OOOOOOOOO    W
W                                                     OOOOOOOODD  DDOOOOOOO    W
W                                                             OOOOOO           W
W                                                             OOOOOO           W
W                                                             OOOOOO           W
W                                                               OO             W
W                                                               OO             W
W                                                               EE             W
W                                                                              W
W                                                                              W
W                                                                              W
W                                                                              W
WWWWWWWWWWWWWWWWWWWWWWWWWWWWWWWWWWWWWWWWWWWWWWWWWWWWWWWWWWWWWWWWWWWWWWWWWWWWWWWW