WWWWWWWWWWWWWWWWWWWWWWWWWWWWWWWWWWWWWWWWWWWWWWWWWWWWWWWWWWWWWWWWWWWWWWWWWWWWWWWW
W                                                                              W
W                                                                              W
W                                                                              W
W                                                                              W
W   WOOOOOOOOOOOOOOObOOOObOOOOOOOOO                                            W
W   WOOOOOOOOOOOOOOOOOOOOOOOOOOOOOOOOOOO                                       W
W   WOOOOPOOOOOOOObOOOOOOOOOOOOOOOOOOOEO                                       W
W   WOOOOOOOOOOOOOOOOOOOOOOOObOOOOOOOOOO                                       W
W   WOOOOOOOOOOOOOOObOOOOOOOOOOOOOO                                            W
W                                                                              W
W                                                                              W
W                                                                              W
W                                                                              W
WWWWWWWWWWWWWWWWWWWWWWWWWWWWWWWWWWWWWWWWWWWWWWWWWWWWWWWWWWWWWWWWWWWWWWWWWWWWWWWW