WWWWWWWWWWWWWWWWWWWWWWWWWWWWWWWWWWWWWWWWWWWWWWWWWWWWWWWWWWWWWWWWWWWWWWWWWWWWWWWW
W                                                                              W
W                                                                              W
W                                                                              W
W                                                                              W
W                                       OOOOOOOOOOOOOOOOOOOOOOOOOOOOO          W
W                                 OOOOOOOOOOOOOOSOOOOOOOOObOOOOOObOOOOOOOOO    W
W                               OPOOOOOOODOOOOOOOOOOOOOObOOOOObOOOOOOOOOOOO    W
W                                 OOOOOOOOOOOOOOSOOOOOOOOObOOOOOObOOO   OOO    W
W                                       OOOOOOOOOOOOOOOsOOOOOOOOOOOOO   OOO    W
W                                                     OOO               OBO    W
W                                                     OsO               OBO    W
W                                                     OOO               OBO    W
W                                                     OsO               OOO    W
W                                                     OOO               OOO    W
W                                                     OOOOOOOOOO  OOOOOOOOO    W
W                                                     OOOOOOOSOO  OOOOOOOOO    W
W                                                             OOOOOO           W
W                                                              OOOO            W
W                                                              OOOO            W
W                                                              OEEO            W
W                                                               OO             W
W                                                                              W
W                                                                              W
WWWWWWWWWWWWWWWWWWWWWWWWWWWWWWWWWWWWWWWWWWWWWWWWWWWWWWWWWWWWWWWWWWWWWWWWWWWWWWWW