WWWWWWWWWWWWWWWWWWWWWWWWWWWWWWWWWWWWWWWWWWWWWWWWWWWWWWWWWWWWWWWWWWWWWWWWWWWWWWWW
W                                                                              W
W                                                                              W
W                                                                              W
W                                                               PP             W
W                                                               OO             W
W                                                               OO             W
W                                                            OOOOOOO           W
W                                                            OLsLBLO           W
W                                                            DLBLsLD           W
W                                                            OLsLBLO           W
W                                                            DLBLsLD           W
W                                                            OLsLBLO           W
W                                                            DLBLsLD           W
W                                                            OLsLBLO           W
W                                                            DLDLDLD           W
W                                                            OOOOOOO           W
W                                                            OOOEOOO           W
W                                                            OOOOOOO           W
W                                                                              W
W                                                                              W
W                                                                              W
W                                                                              W
WWWWWWWWWWWWWWWWWWWWWWWWWWWWWWWWWWWWWWWWWWWWWWWWWWWWWWWWWWWWWWWWWWWWWWWWWWWWWWWW